7
0 0 9 9 9 9 9
0 0 9 2 1 1 9
9 9 9 1 1 1 9
9 1 3 4 3 1 9
9 1 1 1 9 9 9
1 5 1 2 9 0 0
9 9 9 9 9 0 0
