8
0 0 0 0 0 0 0 0
0 0 0 0 0 0 0 0
9 9 9 9 9 9 9 9
9 1 1 1 1 1 2 1
9 9 9 9 3 3 5 1
9 1 1 9 1 1 2 9
9 9 9 9 9 9 9 9
0 0 0 0 0 0 0 0
