7
9 9 9 9 9 9 9
9 1 1 1 1 1 9
9 1 1 3 3 1 9
9 1 3 1 3 5 9
9 2 2 9 9 9 9
9 2 2 9 0 0 0
9 9 9 9 0 0 0
