7
9 9 9 9 9 9 9
9 0 0 0 0 0 9
9 0 0 3 3 0 9
9 0 3 0 3 5 9
9 2 2 9 9 9 9
9 2 2 9 0 0 0
9 9 9 9 0 0 0
